1111111111
10C0000001
100P0E0001
1000000001
1111111111
