111111
1000P1
1000C1
1000E1
111111