111111
1C00P1
100001
100E01
111111