11111111111111111111111111111111111111111
10000000000000000001111111100000000000001
10000001111111110001000000000000000000001
10000000000000000001000000C00000000000001
10001000000000000P01000000010000000000001
1000100000011111111100C000010000000000001
10001000000000000000000000010000000000001
10001000000000000000000111110000000011111
10000000000000000000000000010000000000001
100001C0011100111100000000010000000011111
10C01000010000010000000011111011100000001
10001000100011111110000000000000000000001
1000000000001E000000000000000000000000001
11111111111111111111111111111111111111111
