11111111111111111111111111111111111111111111111111111111111111
10000000000000000000000000000000000000000000000000000000000001
10000000000000000000000000000000000000000000000000000000000001
10000000000000000000000000000000000000000000000000000000000001
10000000000000000000000000P00000000000000000000000000000000001
10000000000000000000000000000000000000000000000000000000000001
10000000000000000000000000000000000000000000000000000000000001
10000000000000000001111111100000000000000000000000000000000001
10000000000000000001000000000000000000000000000000000000000001
10000000000000000001000000C00000000000000000000000000000000001
10000000000000000001000000000000000000000000000000000000000001
10000000000111111111000000000000000000000000000000000000000001
10000000000000000000000000000000000000000000000000000000000001
10000000000000000000000000000000000011111111111111111100000001
10000000000000000000000000000000000000000000000000000000000001
100001C0011100111100000000000000000011111111111111111100000001
10C01000010000010000000000000000000000000000000000000000000001
10001000100010000000000000000000000000000000000000000000000001
10000000000010000000000000000000000000000000000000000E00000001
11111111111111111111111111111111111111111111111111111111111111
