111111111111111111111111111111111111
100000000000000000011111111000000001
100000011111111100010000000000000001
10N000003000000000000000000000000011
10001000000000001P010000000100000001
1000100000011111111100C0000100000001
100010000000000000000000000100000001
100010000000000000000001111100011111
100000000000000000000000000100000001
100001C00111001111100000000100011111
10C0100001000001000111001111101000E1
10001000100011111110N010000000100001
100000000000100000100100000000000101
111111111111111111111111111111111111
