111111111111111111111111111111111111
1000N00C000000N000011111111000N00001
10000001111C1111C001000N0000000C0001
10N00C000000000000000000000000000011
10001000000000001P010000N00100000001
1000100000011111111100C000010N000001
1000100000N0000000000000000100C00001
1000100000111110000C0001111100011111
100000000000C00000000000000100000001
100001C001110N1111100000C0010N011111
10C0100000000000000011000111101000E1
10001N00100011100000N010000000100001
10C0000000001C0000100000000N00000101
111111111111111111111111111111111111
