111111111111111111111111111111111111
100000000000000000011111111000000001
100000011111111100010000000000000001
10000000000000000001000000C000000001
10001000000000001P010000000100000001
1000100000011111111100C0000100060001
100010000000000000000000000100000001
10001000000E000000000001111100011111
100000000000000000000000000100000001
100001C00111001111000000000100011111
10C010000100000100000000111110100001
100010001000111111100000000000000001
100000000000100000000000000000000001
111111111111111111111111111111111111
