11111111111111111111111111111111111111111111111111111111111111111111111111
10000000000000000000000000000000000000000000000000000000000000000000000001
10000000000000000000000000000001111100000000000000000000000000000000000001
11110000000000000001111111111111111111111111111111111100000000000000000001
10001110000000000000000000000000000000000000000000000000000000000000000001
10000001110000000000111111111111111111111111111111111000000000111100C00001
100000000011110000000000000000000010C0100000000000000000000000000010000001
10000000000001000000000000000000001000100000000000000000000110001110000001
1000000000000000000000000000000000100010000000000000000000C001C10000000001
1000C0000000000000000000000000000000000C0000000000000000000000100000000001
10000000111111111100000000000000000000000000000000000000000000000000000001
100000000000000C0100000000000011111111111111111111111111000000000000000001
1000000000000C000100000000000000000000001000000000000000000000000000000001
10000000000000000000000000000000000000010000000000001111111111111111100001
10000000000000011111111111111111111111111000000000000000000000000000000001
100000000000000C0000000000000000000000000000000010000001000000000010000001
1000000000000000000000000000000000000000100000001100000111111000001C000001
10000000000010010000000000000000000000001000000010000001000000000010111001
100C0000000010011111111111111111111111111111111110000001000000000000000001
1000000000001001C000000000000000000000C00000000000000000000P00000000000001
1000000000001C010000000000000000000000000000000011111111111111111111111111
100000000011111100000C0000111111111111111100000000000001000E00000000000001
10000000000000000000000000000000000000000000000000000001000000000000000001
100000000000000000C00000000000000000000C0000000000000000C00000000000000001
10000000000000000000000000000000000000000000000000000000000000000000000001
11111111111111111111111111111111111111111111111111111111111111111111111111
