11111111111111
1E1000N0000P01
10000000000011
100000000N0C00
11111111111111
