11111111
10000001
10P00001
10000C01
1E000001
11111111
