111111111111111111111111111111111111111111111111111111111111111111111111111111111111
100000000000000000011111111000000000000000000000000000000000000000000000000000000001
1000000111111111000100000000000000000000000000000000000001111111C0000000000101000001
10000000000000000001000000C000000000000011111111111111111000000000000000000010000001
10001000000000001P010000000100000000000000000000000000000000000000000000000010000001
1000100000011111111100C0000100060000000000000000000000001111111110000000011111000001
100010000000000000000000000100000000000000000000000000000000000000000000000000100001
10001000000000000000000111110001111000000010000C000001000000000000000000000000000001
100000000000000000000000000100000000000000111100000001000000000000000000000000000001
100001C001110011110000000001000111100000001C0000000001000011111111111111100000000001
10C0100001000001000000001111101000E0000000100000000001000000000000000000000000000001
100010001000111111100000000000000000000111100000000001000000000000000000000000000001
10000000000010000000000000000000000C000000000000000000000011111111111111111100000001
100000000000111100000000000000000000000000000000000000000000000001000000000000000001
100000000000000000000001111111111111111111111110000110000010000001000000000000000001
100000000000000000000000000000000000000000000000000000000010000001000000000000000001
100000000000100000000001111111111111111111111110000000000010000001000000000000000001
100000000000100000000000000000000000000000000000000000000000000000000000000000000001
100000000000100000000000000000000000000000000000011111111110000000000000001111111111
100000000000100000000000000000000000000000000000000000000000000000000000000000000001
111111111111111111111111111111111111111111111111111111111111111111111111111111111111
