1111111111111111111111111111111111111
1000000000000000000111111110000000001
1000000111111111000100000000000000001
10000000000000000001000000C0000000001
10001000000000000P0100000001000000001
1000100000011111111100C00001000000001
1000100000000000000000011111000001111
1000000000000000000000000001000000001
100001C001110011110000000001000001111
10C0100001000001000000001111101110001
1000100010001111111000000000000000001
1000000000001E00000000000000000000001
1111111111111111111111111111111111111
