11111111111111
1E1000N0000P01
10000001110011
100000000N1C01
11111111111111
