11111111111111
1E1000N0000P01
100111100C0
100N0C00000001
11111111111111
