111111111111111111111111111111111111111
10000000000000000000000000N000100000101
1000011111111100E00000000000001000C0101
10000000000000000N000000110000100000101
100N00C000001111100000110C0000100111101
10000000000000C0000011000000001000C01C1
10000C011111111111111111000000N00000101
1000000000000000000P0000000000100000101
100000110C000000000000011100001000C0101
10000011111111111110000000C000100000101
100000000000000000000000000000100000101
100000C000001000010000000000000000C0101
100000000000100C10000000000000100000001
100011110000100100000000000E00100111001
1000000000000000100000000N0000000000001
100000000C00N010010000000000C0000000111
1000C0000011111000100000000000000100001
1000000000000C10000C00000110110001100C1
100010000111111000000100010C01000111111
10001000000000N000C001000100010000000C1
111111111111111111111111111111111111111
