1111111111111111111111111
10000000000C0101010100001
1000E00000111010101011001
1000000000000000P00001001
10000C0000010111000010001
1000000000101000000100001
10111110001100C0011000001
1010C00000111111111111001
10100010000000C0000000001
1111111111111111111111111
