1111111111111111111111111
10000000000C0000000000001
1000E00000111111111111001
1000000000100000000001001
10000C00001000P0000001001
1000000000100000000001001
10111110001000C0000001001
1010C01000111111111111001
10100010000000C0000000001
1111111111111111111111111
