1111111111111111111111111111111111111111
10C000000C00000000C00000000C000000000C01
100010N11110E0N11100C0000111110000000001
10001001C0000000C000000C00000000C010C101
10C01C0100000001111111111111111111111111
100P10010000000C00000000N0000C0000000001
10000000C0000000C0000100001110C00001C011
1C1111000000100100C0001C010C00000N01N011
100C010011001001100001111111111111111111
100001C000001101C0000000000N00000C00C001
1C0001N000C01C010C00000000C000N000000001
1000000000111111000011111111111111111111
100010C0000C000C0000001C0000N00000000001
1000100N00N1110000C000100C00000000C00C01
10001111100001000N00000000000C000000C001
100000C01C0N0100001111N00C1111111N001001
10C000001111000000111100000000C000000C01
10000C00C001110C000C00000111110000000001
100000001111110000111100000001000C0000C1
10CN0000000N00000C000C0000000000CN00C001
1111111111111111111111111111111111111111
