111111111111111111111111111111111111111111
100000000000000000000000000000000000000001
100000N00000E00000000000000000011111000001
100000000000000000000000000000000000000101
100000000000000111111111111111111111111111
100P00000000000C00000000000000000000000001
100000000000000000000000000000000000000011
100000000000100100000000000000000000000011
100C00000000100111111111111111111111111111
1000000000001001C000000000000000000000C001
100000N000001C0100000000000000000000000001
100000000011111100000C00001111111111111111
100000000000000000000000000000000000000001
1000000N0000000000C00000000000000000000C01
100000000000000000000000000000000000000001
111111111111111111111111111111111111111111
