1111111111111111111111111
10000001000C0101010100001
1000E00100111010101011001
10N0000000000000P00N01001
10000C0000010111000010001
1000000000101000000100001
10110110001100C0011000001
1010C01000111111111111001
10100010000000C0000000001
1111111111111111111111111
