1111111111111111111111111111111111111111111111111111111111111111111111111111111111111111111111111111111111111111111111111111111111111111111111
1000000000000000000000000000000000000000000000000000000000000000000000000000000000000000000000000000000000000000000000000000000000000000000001
1000000000000000000000000000000000000000000000000000000000000000000000000000000000000000000000000000000000000000000000000000000000000000000001
1000000000000000000000000000000000000000000000000000000000000000000000000000000000000000000000000000000000000000000000000000000000000000000001
1000000000000000000000000000000000000000000000000000000000000000000000000000000000000000000000000000000000000000000000000000000000000000000001
1000000000000000000000000000000000000000000000000000000000000000000000000000000000000000000000000000000000000000000000000000000000000000000001
1000000000000000000000000000000000000000000000000000000000000000000000000000000000000000000000000000000000000000000000000000000000000000000001
1000000000000000000000000000000000000000000000000000000000000000000000000000000000000000000000000000000000000000000000000000000000000000000001
1000000000000000000000000000000000000000000000000000000000000000000000000000000000000000000000000000000000000000000000000000000000000000000001
1000000000000000000000000000000000000000000000000000000000000000000000000000000000000000000000000000000000000000000000000000000000000000000001
1000000000000000000000000000000000000000000000000000000000000000000000000000000000000000000000000000000000000000000000000000000000000000000001
1000000000000000000000000000000000000000000000000000000000000000000000000000000000000000000000000000000000000000000000000000000000000000000001
1000000000000000000000000000000000000000000000000000000000000000000000000000000000000000000000000000000000000000000000000000000000000000000001
1000000000000000000000000000000000000000000000000000000000000000000000000000000000000000000000000000000000000000000000000000000000000000000001
1000000000000000000000000000000000000000000000000000000000000000000000000000000000000000000000000000000000000000000000000000000000000000000001
1000000000000000000000000000000111110000000000000000000000000000000000000000000000000000000000000000000000000000000000000000000000000000000001
1000000000000000000000000000000111110000000000000000000000000000000000000000000000000000000000000000000000000000000000000000000000000000000001
1000000000000000000000000000000111110000000000000000000000000000000000000000000000000000000000000000000000000000000000000000000000000000000001
1000000000000000000000000000000111110000000000000000000000000000000000000000000000000000000000000000000000000000000000000000000000000000000001
1000000000000000000000000000000111110000000000000000000000000000000000000000000000000000000000000000000000000000000000000000000000000000000001
1000000000000000000000000000000111110000000000000000000000000000000000000000000000000000000000000000000000000000000000000000000000000000000001
1000000000000000000000000000000111110000000000000000000000000000000000000000000000000000000000000000000000000000000000000000000000000000000001
1000000000000000000000000000000111110000000000000000000000000000000000000000000000000000000000000000000000000000000000000000000000000000000001
1000000000000000000000000000000111110000000000000000000000000000000000000000000000000000000000000000000000000000000000000000000000000000000001
1000000000000000000000000000000111110000000000000000000000000000000000000000000000000000000000000000000000000000000000000000000000000000000001
1000000000000000000000000000000111110000000000000000000000000000000000000000000000000000000000000000000000000000000000000000000000000000000001
1000000000000000000000000000000111110000000000000000000000000000000000000000000000000000000000000000000000000000000000000000000000000000000001
1000000000000000000000000000000111110000000000000000000000000000000000000000000000000000000000000000000000000000000000000000000000000000000001
1000000000000000000000000000000111110000000000000000000000000000000000000000000000000000000000000000000000000000000000000000000000000000000001
1111000000000000000111111111111111111111111111111111110000000000001111111111111111111011011011011011011011011011011011011011011011011000000001
1000111000000000000000000000000000000000000000000000000000000000000000000000000000000100100100100100100100100100100100100100100100100100000001
1000000111000000000011111111111111111111111111111111100000000011110000000000000000000000000000000000000000000000000000000000000000000000C00001
100000000011110000000000000000000010C010000000000000000000000000000000000000000000000000000000000000000000000000000000000000000000000010000001
1000000000000100000000000000000000100010000000000000000000011000110000000000000000000000000000000000000000000000000000000000000000000010000001
1000000000000000000000000000000000100010000000000000000000C001C1000000000000000000000000000000000000000000000000000000000000000000000000000001
1000C0000000000000000000000000000000000C000000000000000000000010000000000000000000000C00C00C00C00C00C00C00C00C00C00C00C00C00C00C00C00C00000001
1000000011111111110000000000000000000000000000000000000000000000000000000000000000000000000000000000000000000000000000000000000000000000000001
100000000000000C010000000000001111111111111111111111111100000000000000000000000000000000000000000000000000000000000000000000000000000000000001
1000000000000C00010000000000000000000000100000000000000000000000000000000000000000000000000000000000000000000000000000000000000000000000000001
1000000000000000000000000000000000000001000000000000111111111111110000000000000000000000000000000000000000000000000000000000000000000011100001
1000000000000001111111111111111111111111100000000000000000000000000000000000000000000000000000000000000000000000000000000000000000000000000001
100000000000000C000000000000000000000000000000001000000100000000000000000000000000000000000000000000000000000000000000000000000000000010000001
100000000000000000000000000000000000000010000000110000011111100000000000000000000000000000000000000000000000000000000000000000000000001C000001
1000000000001001000000000000000000000000100000001000000100000000000000000000000000000000000000000000000000000000000000000000000000000010111001
100C00000000100111111111111111111111111111111111100000010000000000000000000000000000C00C00C00C00C00C00C00C00C00C00C00C00C00C00C00C00C000000001
1000000000001001C000000000000000000000C00000000000000000000P0000000000000000000000000000000000000000000000000000000000000000000000000000000001
1000000000001C01000000000000000000000000000000001111111111111111110000000000000000000000000000000000000000000000000000000000000000000011111111
100000000011111100000C0000111111111111111100000000000001000E0000000000000000000000000000000000000000000000000000000000000000000000000000000001
1000000000000000000000000000000000000000000000000000000100000000000000000000000000000000000000000000000000000000000000000000000000000000000001
100000000000000000C00000000000000000000C0000000000000000C0000000000000000000000000000000000000000000000000000000000000000000000000000000000001
1000000000000000000000000000000000000000000000000000000000000000000000000000000000000000000000000000000000000000000000000000000000000000000001
1111111111111111111111111111111111111111111111111111111111111111111111111111111111111111111111111111111111111111111111111111111111111111111111
