1111111111111111111111111111111111111111
10C0000C000000000C00P0000000C000000000C1
101N011111111111111111111111111110011001
1000C000000000C0000N00000C000N0010001C01
1000010000001111111111111111111110001001
1001010000C010000000C000000000C00000N001
10010100000011111111111111111111111100C1
100C010C0000000000C00000000N0000C0010001
1000N0000000C00000N000000C00000000N1C001
1000C00111111111111111111111111111110001
10000001000P0C000C0000000C00000N000C0001
1000C001111111111111111111111111110C1001
10000000C0000000N00C00000C00000C010011C1
100N000C00000000C0000000C000000001000001
10000001111111111100C0011111111111000001
10N0000100C00000C000000000C0000001110001
1000000111111111111111111111000C00000C01
10000N00000C00000N000000C001111111100001
1000C00000111111111111111111000C000N00C1
1000000N0000C00000N00000C0000N00000C0001
1111111111111111111111111111111111111111
